6.1 

161 kobiet 
119 mezczyzn

6.2 

autobus	1
pociag	5
rower	13
samochod	4
tramwaj	20

6.3 

Dolnoslaskie	30
Mazowieckie	43
Slaskie	23
Wielkopolskie	30

6.4 

Maria	Bobowik	Lubelskie
Elzbieta	Borowska	Malopolskie
Anna	Borowska	Malopolskie
Sebastian	Busma	Lubuskie
Marta	Czajewska	Pomorskie
Barbara	Dziegielewska	Pomorskie
Piotr	Gawkowski	Podkarpackie
Kamila	Glowacka	Swietokrzyskie
Andrzej	Iwaszczuk	Mazowieckie
Michal	Janasz	Mazowieckie
Justyna	Jankowska	Mazowieckie
Marcin	Jasinski	Mazowieckie
Grzegorz	Kanadys	Warminsko - Mazurskie
Katarzyna	Karwowska	Mazowieckie
Marta	Kimsza	Pomorskie
Klara	Klimaszewska	Dolnoslaskie
Emilia	Kobeszko	Lubelskie
Maria	Korol	Malopolskie
Piotr	Korzunowicz	Dolnoslaskie
Karolina	Kozlowska	Mazowieckie
Monika	Krasowska	Lubelskie

6.5

3250